F 255,255,255

NO ./assets/cobble.xpm

C 255,0,0


SO ./assets/13878215-grass-block-side_m.xpm

WE ./assets/Unknown.xpm

EA ./assets/worst_image.xpm






                        11111111111
                        10000000001
                        10000000001
                        11000000011
11111    1111111111111111110000011
10001    100000000000000000000001
10S011111101111111111111111000001
10001    100000000000000001111111
11011    111111111111111101                          11111111
100011111110000000000000001                         1100000011
10001000011011111111111111111111111111111          110000000011
1000000001101               1000000000001         11000000000011
1000100001101               100000000000111111111110000000000001
100011111110111111          100000000000000000000000000001000001
100011000000000001          100000000000111111111110000000000001
100011000000000001          1000000000001         11000000000011
10001100000000000111111111111000000000001          110000000011
10001100000000000000000000000000011111111           1100000011
1000110000000000011111111111110001                   11111111
100001000000000001           10001
100000000000000001           10001
100001000000000001           10001
100011000000000001          110001
100011000000000001         1100011
100011000000000001        1100011
100011000000000001       1100011
100011111111111111      1100011
100011          11111111100011
10011        1111000001100011
1011       11100000000000011
101       1100000000000000011
101      110000000000000000011
101111111100000000000000000001
100000000000000000000000000001
111111111100000000000000000001
         110000000000000000011
          1100000000000000011
           11100000000000111
             1111000001111
                1111111



